xdxxxxxxxxxxx
x   p       x
x xx xxx xx x
x x       x x
x x xxxxx xpx
x   xd e  x x
x x     x   x
x x xxxxx x x
xpx   p   x x
x xxx x xxd x
x      p    x
xxxxxxxxxxxxx
