xdxxxxxxxxxxx
x   p   f   x
x xx xxx xx x
x x   p   x x
xfx xxxxx xpx
x   xd e  x x
x x     x   x
x x xxxxx xfx
xpx   p   x x
x xxx x xxd x
x  f    p   x
xxxxxxxxxxxxx
