xdxxxxxxxxxxx
x     p f  px
x xx xxx xx x
x xp      x x
xfx xxxxx xpx
x   xd e  x x
x x   p x   x
xpx xxxxx xfx
x x      px x
x xxx x xxd x
xp f  p     x
xxxxxxxxxxxxx
